O   SD    O    O    O    O    O    O    O    O    O    O
O    D    O    D    L    L    L    L    L    L    L    O
O    D    O    D    O    O    O    O    O    O    U    O
O    D    O    D    O    D    L    L    L    O    U    O
O    D    O    D    O    E    O    O    U    O    U    O
O    D    O    D    O    O    O    O    U    O    U    O
O    D    O    R    R    R    R    R    U    O    U    O
O    D    O    O    O    O    O    O    O    O    U    O
O    R    R    R    R    R    R    R    R    R    U    O
O    O    O    O    O    O    O    O    O    O    O    O