O    SD   O    O    O    O    O    O    O    O    O    D    O
O    D    O    R    R    D    O    R    R    R    R    D    O
O    D    O    U    O    D    O    U    O    O    O    D    O
O    D    O    U    O    D    O    U    L    L    O    D    O
O    D    O    U    O    D    O    O    O    U    O    D    O
O    D    O    U    O    D    O    R    R    U    O    D    O
O    D    O    U    O    D    O    U    O    O    O    D    O
O    D    O    U    O    D    O    U    L    L    O    D    O
O    D    O    U    O    D    O    O    O    U    O    D    O
O    R    R    U    O    R    R    R    R    U    O    D    O
O    O    O    O    O    O    O    O    O    O    O    E    O