O    SD   O    O    O    O    O    O    O    O    O    O    O
O    D    O    O    O    O    O    O    O    O    O    O    O
O    D    O    O    O    O    O    O    O    O    O    O    O
O    D    O    O    O    O    O    O    O    O    O    O    O
O    D    O    O    O    O    O    O    O    O    O    O    O
O    D    O    O    O    O    O    O    O    O    O    O    O
O    D    O    O    O    O    O    O    O    O    O    O    O
O    D    O    O    O    O    O    O    O    O    O    O    O
O    D    O    O    O    O    O    O    O    O    O    O    O
O    D    R    E    O    O    O    O    O    O    O    O    O
O    O    O    O    O    O    O    O    O    O    O    O    O
