O    SD   O    O    O    O    O    O    O    O    O    O    O
O    D    O    O    O    O    O    O    O    O    O    O    O
O    D    O    O    O    O    O    O    O    O    O    O    O
O    D    O    O    O    O    O    O    O    O    O    O    O
O    D    O    O    O    O    O    O    O    O    O    O    O
O    D    O    O    O    O    O    O    O    O    O    O    O
O    D    O    O    O    O    O    O    O    O    O    O    O
O    D    O    O    O    O    O    O    O    O    O    O    O
O    D    O    O    O    O    O    O    O    O    O    O    O
O    R    R    E    O    O    O    O    O    O    O    O    O
O    O    O    E    O    O    O    O    O    O    O    O    O
